111111111111111111111111111
1000000000PEC00000000000001
111111111100011111111111111
111111111111111111111111111
