111111111
1000E0011
111111011
111PC1111
111111111
