1111111111111111111
100001100111111C0E1
1C00C11000000110001
1P001110000000000C1
100C001000011000001
1000000000111100001
1000110000111100001
1000111000C11C00C01
1111111111111111111