1111111111111111111111
1P00000000000000000001
1110000000000000000001
1000000000000000000001
1000000111000000000001
10000001E1000000000001
1000000C00000000000001
1000000000000000000111
10000000000000000000C1
1111111111111111111111
